16 16
3 10
111111111111111
111111111111111
111111111111111
111111111111111
001111111111100
001111111111100
001111111111100
001111000111100
001111000111100
001111000111100
001111111111100
001111111111100
001111111111100
111111111111111
111111111111111
111111111111111
111111111111111
111111111111111
111111111111110
111111111111110
111111111111110
111111111111110
111111111111110
111111111111110
111111111111110
111111111111110
111111111111111
111111111111111
111111111111111
111111111111111
Level 7: Star shape – place 3 cells in different arms